Mm, Mm, Mm, Hhd, Re, Re, Gd, Re, Gd, Ww, Gd^Fp, Gd, Gd, Hhd, Mm, Mm, Mm, Mm, Xu, Xu, Xu, Xu
Mm, Mm, Mm, Hhd, Re, Re, Gd, Re, Gd, Ww, Gd^Fp, Gd, Gd, Hhd, Mm, Mm, Mm, Mm, Xu, Xu, Xu, Xu
Mm, Mm, Re, Re, Hhd, Hhd, Hhd^Vc, Gd, Gd, Ww, Gd^Fp, Gd^Vo, Gd, Hhd, Mm, Mm, Xu, Xu, Cte, Xu, Xu, Xu
Mm, Mm, Uu, Mm, Mm, Mm, Hhd, Gd, Gd, Ww, Ww, Gd^Fp, Gd, Hhd, Mm, Mm, Uh, Cte, 3 Kte, Cte, Xu, Xu
Xu, Xu, Uu, Xu, Mm, Mm, Mm, Hhd, Gd, Gd, Gd, Ww, Gd, Hhd, Hhd, Mm, Uu, Cte, Cte, Cte, Xu, Xu
Xu, Xu, Uu, Xu, Xu, Mm, Mm, Hhd, Gd, Gd, Ww, Ww, Gd, Gd, Re, Re, Mm, Uh, Xu, Xu, Xu, Xu
Xu, Xu, Uu, Uu, Uu, Mm, Hhd, Hhd, Gd, Gd, Ww, Gd, Re, Re, Gd, Hhd, Mm, Mm, Mm, Mm, Mm, Mm
Xu, Xu, Xu, Xu, Mm, Re, Re, Gd, Gd, Gd, Ww^Bw/, Re, Gd, Gd, Hhd, Hhd, Hhd, Mm, Mm, Mm, Mm, Mm
Xu, Xu, Mm, Mm, Mm, Hhd, Hhd, Re, Re, Re, Gd, Ww, Gd, Gd^Vo, Gd, Hhd, Gd, Hhd, Mm, Mm, Mm, Mm
Mm, Mm, Mm, Mm, Mm, Hhd, Hhd^Vc, Gd, Gd, Re, Gd, Ww, Gd, Gd, Gll^Fp, Gd, Gd, Hhd, Mm, Mm, Mm, Mm
Mm, Mm, Mm, Hhd, Hhd, Hhd, Hhd, Gd, Gd, Re, Gd, Ww, Ww, Gd, Gll^Fp, Gll^Fp, Gd, Hhd, Mm, Mm, Mm, Mm
Mm, Mm, Mm, Mm, Mm, Mm, Mm, Hhd, Gd, Re, Re, Gd, Ww, Gd, Gd, Gd, Hhd, Hhd, Mm, Mm, Mm, Mm
Mm, Mm, Mm, Mm, Mm, Mm, Hhd, Hhd, Re, Gd^Vo, Re, Gd, Gd, Ww, Gd, Gd, Gd, Hhd, Hhd, Mm, Mm, Mm
Xu, Xu, Xu, Xu, Uh, Mm, Re, Re, Gd, Re, Gd, Re, Re, Ww, Gd, Gd, Gd, Hhd^Vc, Hhd, Mm, Mm, Mm
Xu, Xu, Cte, Cte, Cte, Uu, Mm, Gd, Hhd, Gd, Gll^Fp, Gd, Ww, Ww^Bw\, Re, Gll^Fp, Gll^Fp, Hhd, Hhd, Mm, Mm, Mm
Xu, Xu, Cte, 2 Kte, Cte, Uh, Mm, Mm, Hhd, Gd, Gd, Gd, Ww, Gd, Gd, Re, Gll^Fp, Gd, Hhd, Mm, Mm, Mm
Xu, Xu, Xu, Cte, Xu, Xu, Mm, Mm, Hhd, Gd^Vc, Gd, Gd, Ww, Gd, Gd, Re, Gll^Fp, Gll^Fp, Hhd, Mm, Mm, Mm
Xu, Xu, Xu, Xu, Mm, Mm, Mm, Mm, Hhd, Hhd, Gd, Gd, Gd, Ww, Gd, Re, Re, Gd, Gd, Hhd, Gd, Gd
Xu, Xu, Xu, Mm, Mm, Mm, Hhd, Hhd, Gd, Gd, Gd, Gll^Fp, Gd, Ww, Gd^Vo, Gd, Ce, Ce, Ce, Gd, Gll^Fp, Gll^Fp
Mm, Mm, Mm, Mm, Mm, Hhd, Hhd^Vc, Gd, Gd, Gd, Hhd, Gd, Gd, Ww, Ww, Gd, Ce, 1 Ke, Ce, Gd, Gd, Gd
Mm, Mm, Mm, Mm, Mm, Hhd, Hhd, Hhd, Hhd, Hhd, Gll^Fp, Gll^Fp, Gll^Fp, Gd, Ww, Gd, Gd, Ce, Gd, Re, Re, Re
Mm, Mm, Mm, Mm, Mm, Hhd, Hhd, Hhd, Hhd, Hhd, Gll^Fp, Gll^Fp, Gll^Fp, Gd, Ww, Gd, Gd, Gd, Gd, Re, Re, Re
